111111111111111
110000000000011
102101101101201
101101101101101
100000000000001
101101010101101
100000010000001
110110111011011
110110000011011
100000111000001
101110030011101
100000111000001
101110000011101
100000111000001
111111111111111